Module	Class
BreedingEdge	breed.arch
BreedingGraph	breed.arch
BreedingNode	breed.arch
BreedingProgram	breed.arch
EmigrationOperator	breed.arch
GermplasmBank	breed.arch
ImmigrationOperator	breed.arch
RecurrentSelectionBreedingProgram	breed.arch
BreedingValueProtocol	breed.prot.bv
TrueBreedingValue	breed.prot.bv
G_E_RnE_EstimatedBreedingValue	breed.prot.bv
GenotypingProtocol	breed.prot.gt
FourWayCross	breed.prot.mate
FourWayDHCross	breed.prot.mate
GenerationalTwoWayDHCross	breed.prot.mate
MatingProtocol	breed.prot.mate
SelfCross	breed.prot.mate
ThreeWayCross	breed.prot.mate
ThreeWayDHCross	breed.prot.mate
TwoWayCross	breed.prot.mate
TwoWayDHCross	breed.prot.mate
mate_util	breed.prot.mate
PhenotypingProtocol	breed.prot.pt
TruePhenotyping	breed.prot.pt
G_E_Phenotyping	breed.prot.pt
ConventionalGenomicSelection	breed.prot.sel
SelectionProtocol	breed.prot.sel
WeightedGenomicParentSelection	breed.prot.sel
RandomSelection	breed.prot.sel
ConventionalPhenotypicSelection	breed.prot.sel
MultiObjectiveGenomicMating	breed.prot.sel
MultiObjectiveGenomicSelection	breed.prot.sel
OptimalContributionSelection	breed.prot.sel
MatingConfiguration	breed.prot.mcfg
WeightedRandomMatingConfiguration	breed.prot.mcfg
InitializationOperator	breed.op.init
GenerationalInitializationOperator	breed.op.init
RandomInitializationOperator	breed.op.init
SimpleInitializationOperator	breed.op.init
EvaluationOperator	breed.op.eval
PerformanceTrial	breed.op.eval
TrueEvaluationOperator	breed.op.eval
NoGxEEvaluationOperator	breed.op.eval
ParentSelectionOperator	breed.op.psel
ConventionalGenomicParentSelection	breed.op.psel
ConventionalPhenotypicParentSelection	breed.op.psel
OptimalContributionParentSelection	breed.op.psel
OptimalPopulationValueParentSelection	breed.op.psel
TwoWayExpectedMaximumBreedingValueParentSelection	breed.op.psel
TwoWayOptimalHaploidValueParentSelection	breed.op.psel
WeightedGenomicParentSelection	breed.op.psel
RandomParentSelection	breed.op.psel
MultiObjectiveGenomicParentSelection	breed.op.psel
SurvivorSelectionOperator	breed.op.ssel
ConventionalGenomicSurvivorSelection	breed.op.ssel
ConventionalPhenotypicSurvivorSelection	breed.op.ssel
FamilyPhenotypicSurvivorSelection	breed.op.ssel
OptimalContributionSurvivorSelection	breed.op.ssel
WeightedGenomicSurvivorSelection	breed.op.ssel
RandomFamilySurvivorSelection	breed.op.ssel
FourWayDHCross	breed.op.mate
ThreeWayDHCross	breed.op.mate
mate_util	breed.op.mate
GenerationalTwoWayDHCross	breed.op.mate
MatingOperator	breed.op.mate
TwoWayDHCross	breed.op.mate
BasicLogbook	breed.op.log
BlankLogbook	breed.op.log
Logbook	breed.op.log
GenotypeEffectMatrix	model.emat
HaplotypeEffectMatrix	model.emat
PhasedGenotypeEffectMatrix	model.emat
PhasedHaplotypeEffectMatrix	model.emat
EffectMatrix	model.emat
GenotypeEffectVariantMatrix	model.emat
HaplotypeEffectVariantMatrix	model.emat
PhasedGenotypeEffectVariantMatrix	model.emat
PhasedHaplotypeEffectVariantMatrix	model.emat
LMMg_A	model.gmod
LinearGenomicModel	model.gmod
LinearMixedGenomicModel	model.gmod
NonlinearGenomicModel	model.gmod
GenericLinearGenomicModel	model.gmod
GenomicModel	model.gmod
AdditiveGeneticVarianceMatrix	model.vmat
AdditiveGenicVarianceMatrix	model.vmat
DihybridDHAdditiveGeneticVarianceMatrix	model.vmat
FourWayDHAdditiveGeneticVarianceMatrix	model.vmat
GeneticVarianceMatrix	model.vmat
GenicVarianceMatrix	model.vmat
ThreeWayDHAdditiveGeneticVarianceMatrix	model.vmat
TwoWayAdditiveGenicVarianceMatrix	model.vmat
TwoWayDHAdditiveGeneticVarianceMatrix	model.vmat
VarianceMatrix	model.vmat
vmat_util	model.vmat
CoancestryMatrix	popgen.cmat
DenseMolecularCoancestryMatrix	popgen.cmat
DenseVanRadenCoancestryMatrix	popgen.cmat
DenseCoancestryMatrix	popgen.cmat
ExtendedGeneticMap	popgen.gmap
GeneticMap	popgen.gmap
GeneticMapFunction	popgen.gmap
HaldaneMapFunction	popgen.gmap
KosambiMapFunction	popgen.gmap
StandardGeneticMap	popgen.gmap
gmap_util	popgen.gmap
DenseGeneticMappableMatrix	popgen.gmap
GeneticMappableMatrix	popgen.gmap
DenseHaplotypeMatrix	popgen.hmat
DensePhasedHaplotypeMatrix	popgen.hmat
HaplotypeMatrix	popgen.hmat
PhasedHaplotypeMatrix	popgen.hmat
LDMatrix	popgen.ldmat
ldmat_util	popgen.ldmat
D_LDMatrix	popgen.ldmat
Dprime_LDMatrix	popgen.ldmat
R_LDMatrix	popgen.ldmat
Rsq_LDMatrix	popgen.ldmat
DenseGenotypeMatrix	popgen.gmat
DensePhasedGenotypeMatrix	popgen.gmat
GenotypeMatrix	popgen.gmat
HaplotypeMatrix	popgen.gmat
PhasedGenotypeMatrix	popgen.gmat
PhasedHaplotypeMatrix	popgen.gmat
PandasPhenotypeDataFrame	popgen.ptdf
PhenotypeDataFrame	popgen.ptdf
BreedingValueMatrix	popgen.bvmat
DenseBreedingValueMatrix	popgen.bvmat
DenseEstimatedBreedingValueMatrix	popgen.bvmat
DenseGenomicEstimatedBreedingValueMatrix	popgen.bvmat
ExtendedGeneticMap_test	test.popgen.gmap
GeneticMapFunction_test	test.popgen.gmap
GeneticMap_test	test.popgen.gmap
HaldaneMapFunction_test	test.popgen.gmap
KosambiMapFunction_test	test.popgen.gmap
StandardGeneticMap_test	test.popgen.gmap
gmap_util_test	test.popgen.gmap
DenseGenotypeMatrix_test	test.popgen.gmat
GenotypeMatrix_test	test.popgen.gmat
DensePhasedGenotypeMatrix_test2	test.popgen.gmat
DensePhasedGenotypeMatrix_test	test.popgen.gmat
HaplotypeMatrix_test	test.popgen.gmat
PhasedGenotypMatrix_test	test.popgen.gmat
PhasedHaplotypeMatrix_test	test.popgen.gmat
BreedingValueMatrix_test	test.popgen.bvmat
DenseBreedingValueMatrix_test	test.popgen.bvmat
DenseGenotypicEstimatedBreedingValueMatrix_test	test.popgen.bvmat
DensePhenotypicEstimatedBreedingValueMatrix_test	test.popgen.bvmat
DenseEstimatedBreedingValueMatrix_test	test.popgen.bvmat
CoancestryMatrix_test	test.popgen.cmat
DenseCoancestryMatrix_test	test.popgen.cmat
DenseMolecularCoancestryMatrix_test	test.popgen.cmat
DenseVanRadenCoancestryMatrix_test	test.popgen.cmat
DensePhasedHaplotypeVariantMatrix_test	test.popgen.hmat
DenseHaplotypeMatrix_test	test.popgen.hmat
DensePhasedHaplotypeMatrix_test	test.popgen.hmat
HaplotypeMatrix_test	test.popgen.hmat
PhasedHaplotypeMatrix_test	test.popgen.hmat
D_LDMatrix_test	test.popgen.ldmat
Dprime_LDMatrix_test	test.popgen.ldmat
LDMatrix_test	test.popgen.ldmat
R_LDMatrix_test	test.popgen.ldmat
Rsq_LDMatrix_test	test.popgen.ldmat
ldmat_util_test	test.popgen.ldmat
GroupableMatrix_test	test.core.mat
Matrix_test	test.core.mat
MutableMatrix_test	test.core.mat
PhasedMatrix_test	test.core.mat
SortableMatrix_test	test.core.mat
TaxaMatrix_test	test.core.mat
TraitMatrix_test	test.core.mat
VariantMatrix_test	test.core.mat
mat_util_test	test.core.mat
PrunableMatrix_test	test.core.mat
DenseMatrix_test	test.core.mat
DenseMutableMatrix_test	test.core.mat
TaxaVariantMatrix_test	test.core.mat
TaxaTraitMatrix_test	test.core.mat
DensePhasedMatrix_test	test.core.mat
DenseTaxaMatrix_test	test.core.mat
DenseVariantMatrix_test	test.core.mat
DenseTraitMatrix_test	test.core.mat
DensePhasedTaxaVariantMatrix_test	test.core.mat
DenseTaxaVariantMatrix_test	test.core.mat
DenseTaxaTraitMatrix_test	test.core.mat
PhasedTaxaVariantMatrix_test	test.core.mat
random_util_test	test.core.random
error_attr_python_test	test.core.error
error_generic_numpy_test	test.core.error
error_generic_python_test	test.core.error
error_type_numpy_test	test.core.error
error_type_python_test	test.core.error
error_value_numpy_test	test.core.error
error_value_python_test	test.core.error
util_h5py_test	test.core.util
EffectMatrix_test	test.model.emat
GenotypeEffectMatrix_test	test.model.emat
GenotypeEffectVariantMatrix_test	test.model.emat
GenotypeVariantEffectMatrix_test	test.model.emat
HaplotypeEffectMatrix_test	test.model.emat
HaplotypeEffectVariantMatrix_test	test.model.emat
HaplotypeVariantEffectMatrix_test	test.model.emat
PhasedGenotypeEffectMatrix_test	test.model.emat
PhasedGenotypeEffectVariantMatrix_test	test.model.emat
PhasedHaplotypeEffectMatrix_test	test.model.emat
PhasedHaplotypeEffectVariantMatrix_test	test.model.emat
PhasedHaplotypeVariantEffectMatrix_test	test.model.emat
GenomicModel_test	test.model.gmod
LinearGenomicModel_test	test.model.gmod
NonlinearGenomicModel_test	test.model.gmod
GenericLinearGenomicModel_test	test.model.gmod
AdditiveGeneticVarianceMatrix_test	test.model.vmat
AdditiveGenicVarianceMatrix_test	test.model.vmat
DihybridDHAdditiveGeneticVarianceMatrix_test	test.model.vmat
FourWayDHAdditiveGeneticVarianceMatrix_test	test.model.vmat
GeneticVarianceMatrix_test	test.model.vmat
GenicVarianceMatrix_test	test.model.vmat
ThreeWayDHAdditiveGeneticVarianceMatrix_test	test.model.vmat
TwoWayAdditiveGenicVarianceMatrix_test	test.model.vmat
TwoWayDHAdditiveGeneticVarianceMatrix_test	test.model.vmat
VarianceMatrix_test	test.model.vmat
vmat_util_test	test.model.vmat
BreedingEdge_test	test.breed.arch
BreedingGraph_test	test.breed.arch
BreedingNode_test	test.breed.arch
BreedingProgram_test	test.breed.arch
EmigrationOperator_test	test.breed.arch
GermplasmBank_test	test.breed.arch
ImmigrationOperator_test	test.breed.arch
RecurrentSelectionBreedingProgram_test	test.breed.arch
ConventionalGenomicSurvivorSelection_test	test.breed.prot.ssel
ConventionalPhenotypicSurvivorSelection_test	test.breed.prot.ssel
FamilyPhenotypicSurvivorSelection_test	test.breed.prot.ssel
OptimalContributionSurvivorSelection_test	test.breed.prot.ssel
SurvivorSelectionOperator_test	test.breed.prot.ssel
WeightedGenomicSurvivorSelection_test	test.breed.prot.ssel
RandomFamilySurvivorSelection_test	test.breed.prot.ssel
ConventionalGenomicSelection_test	test.breed.prot.sel
ConventionalPhenotypicSelection_test	test.breed.prot.sel
OptimalContributionValueSelection_test	test.breed.prot.sel
RandomSelectionOperator_test	test.breed.prot.sel
WeightedGenomicSelection_test	test.breed.prot.sel
ConventionalGenomicParentSelection_test	test.breed.prot.psel
ConventionalPhenotypicParentSelection_test	test.breed.prot.psel
OptimalContributionParentSelection_test	test.breed.prot.psel
OptimalPopulationValueParentSelection_test	test.breed.prot.psel
ParentSelectionOperator_test	test.breed.prot.psel
TwoWayExpectedMaximumBreedingValueParentSelection_test	test.breed.prot.psel
TwoWayOptimalHaploidValueParentSelection_test	test.breed.prot.psel
WeightedGenomicParentSelection_test	test.breed.prot.psel
MultiObjectiveGenomicParentSelection_test	test.breed.prot.psel
RandomParentSelection_test	test.breed.prot.psel
MatingConfiguration_test	test.breed.prot.mcfg
WeightedRandomMatingConfiguration_test	test.breed.prot.mcfg
FourWayDHCross_test	test.breed.prot.mate
GenerationalTwoWayDHCross_test	test.breed.prot.mate
MatingOperator_test	test.breed.prot.mate
ThreeWayDHCross_test	test.breed.prot.mate
TwoWayDHCross_test	test.breed.prot.mate
mate_util_test	test.breed.prot.mate
BlankLogBook_test	test.breed.op.log
LogBook_test	test.breed.op.log
EvaluationOperator_test	test.breed.op.eval
NoGxEEvaluationOperator_test	test.breed.op.eval
PerformanceTrial_test	test.breed.op.eval
TrueEvaluationOperator_test	test.breed.op.eval
InitializationOperator_test	test.breed.op.init
RandomInitializationOperator_test	test.breed.op.init
GenerationalInitializationOperator_test	test.breed.op.init
SimpleInitializationOperator_test	test.breed.op.init
subroutines_test	test.util
generic_numpy	test
generic_numpy_mathops	test
generic_python	test
subroutines	util
DenseMutableMatrix	core.mat
GroupableMatrix	core.mat
MutableMatrix	core.mat
SortableMatrix	core.mat
mat_util	core.mat
PrunableMatrix	core.mat
DenseMatrix	core.mat
DensePhasedMatrix	core.mat
DensePhasedTaxaVariantMatrix	core.mat
DenseTaxaMatrix	core.mat
DenseTaxaVariantMatrix	core.mat
DenseTraitMatrix	core.mat
DenseVariantMatrix	core.mat
Matrix	core.mat
PhasedMatrix	core.mat
PhasedTaxaVariantMatrix	core.mat
TaxaMatrix	core.mat
TaxaTraitMatrix	core.mat
TaxaVariantMatrix	core.mat
TraitMatrix	core.mat
VariantMatrix	core.mat
DenseTaxaTraitMatrix	core.mat
error_attr_python	core.error
error_generic_python	core.error
error_type_python	core.error
error_value_python	core.error
error_io_h5py	core.error
error_io_python	core.error
error_type_numpy	core.error
error_generic_numpy	core.error
error_value_numpy	core.error
error_type_pandas	core.error
random_util	core.random
util_h5py	core.util
util_rpy2	core.util
HDF5InputOutput	core.io
DataFrame	core.df
PandasDataFrame	core.df
DictDataFrame	core.df
ChromosomeDecoder	algo.ga.chrom.decode
NoChromosomeDecoder	algo.ga.chrom.decode
ChromosomeEncoder	algo.ga.chrom.encode
ChromosomeGenerator	algo.ga.chrom.gen
SetChromosomeGenerator	algo.ga.chrom.gen
GeneticAlgorithm	algo.ga.core
CrossoverOperator	algo.ga.cx
UniformSetCrossoverOperator	algo.ga.cx
Logbook	algo.ga.log
MemeticOperator	algo.ga.meme
NoMemeticOperator	algo.ga.meme
StochasticSetHillClimberMemeticOperator	algo.ga.meme
MutationOperator	algo.ga.mut
SetMutationOperator	algo.ga.mut
PopulationGenerator	algo.ga.pop.gen
SetPopulationGenerator	algo.ga.pop.gen
MULTISelectionOperator	algo.ga.sel
SelectionOperator	algo.ga.sel
TournamentSelectionOperator	algo.ga.sel
OptimizationAlgorithm	algo.opt
SteepestAscentSetHillClimber	algo.opt
StochasticAscentSetHillClimber	algo.opt
